createLevel
level2
16
85
0,0,0,0,0,0,0,1,0,7,0,0,0,0,0,0,
7,0,7,0,0,0,0,1,0,6,0,0,0,0,0,0,
6,0,6,0,0,0,0,1,0,6,0,0,0,0,0,0,
6,0,0,0,0,7,0,1,0,6,0,7,0,0,0,0,
0,0,0,0,0,6,0,1,0,6,0,6,0,0,0,0,
0,0,0,7,0,6,0,1,0,0,0,6,0,7,0,0,
0,0,0,6,0,0,0,1,0,0,0,6,0,6,0,0,
0,0,0,6,0,0,0,1,0,0,0,0,0,0,0,0,
0,10,0,10,0,0,0,15,0,10,0,10,0,0,0,0,
16,16,16,16,16,16,16,16,16,16,16,16,16,16,16,16,
13,13,13,13,13,13,13,13,13,13,13,13,13,13,13,13,
13,13,13,13,13,13,13,13,13,13,13,13,13,13,13,13,
13,13,13,13,13,13,13,13,13,13,13,13,13,13,13,13,
13,13,13,13,13,13,13,13,13,13,13,13,13,13,13,13,
13,13,13,13,13,13,13,13,13,13,13,13,13,13,13,13,
11,11,11,11,11,11,11,11,11,11,11,11,11,11,11,11,
0,10,0,10,0,0,0,14,0,10,0,10,0,0,0,0,
9,9,9,9,9,9,9,1,9,9,9,9,9,9,9,9,
8,8,8,8,8,8,8,1,8,8,8,8,8,8,8,8,
8,8,8,8,8,8,8,1,8,8,8,8,8,8,8,8,
17,17,17,17,17,17,17,1,17,17,17,17,17,17,17,17,
0,10,0,10,0,0,0,15,0,10,0,10,0,0,0,0,
16,16,16,16,16,16,16,16,16,16,16,16,16,16,16,16,
13,13,13,13,13,13,13,13,13,13,13,13,13,13,13,13,
13,13,13,13,13,13,13,13,13,13,13,13,13,13,13,13,
13,13,13,13,13,13,13,13,13,13,13,13,13,13,13,13,
13,13,13,13,13,13,7,11,13,13,13,13,13,13,13,13,
13,13,13,13,13,13,6,14,11,13,13,13,13,13,13,13,
13,13,13,13,13,13,6,1,10,13,13,13,13,13,13,13,
13,13,13,13,13,13,10,1,10,13,13,13,13,13,13,13,
13,13,13,13,13,13,0,1,0,13,13,13,13,13,13,13,
13,13,13,13,13,13,16,15,16,13,13,13,13,13,13,13,
13,13,13,13,13,13,13,16,13,13,13,13,13,13,13,13,
13,13,13,13,13,13,13,13,13,13,13,13,13,13,13,13,
13,13,13,13,13,13,13,13,13,13,13,13,13,13,13,13,
13,13,13,13,13,13,13,13,13,13,13,13,13,13,13,13,
13,13,13,13,13,13,13,13,13,13,13,13,13,13,13,13,
13,13,13,13,13,13,13,13,13,13,13,13,13,13,13,13,
13,13,13,13,13,13,13,13,13,13,13,13,13,13,13,13,
11,11,11,11,11,11,11,11,11,11,11,11,11,11,11,11,
0,0,0,0,0,0,0,14,7,0,0,0,0,0,0,0,
0,0,10,0,10,0,0,1,0,10,0,0,0,10,0,0,
0,0,0,0,0,0,0,1,0,0,0,10,0,10,0,0,
0,10,0,0,0,0,0,1,0,0,0,0,0,0,0,0,
0,0,0,0,0,0,0,1,0,10,0,0,0,0,0,0,
0,0,0,0,10,0,0,1,0,0,10,0,10,0,0,0,
0,0,0,0,0,0,0,2,0,0,0,0,0,0,0,0,
0,0,10,0,7,0,0,3,0,0,0,0,10,0,0,0,
0,0,0,0,6,0,0,1,0,0,7,0,0,0,0,0,
5,5,5,5,6,5,5,4,5,5,6,5,5,5,5,5,
0,0,7,0,6,0,0,1,7,0,6,0,0,0,0,0,
0,0,6,0,0,0,0,3,6,0,6,0,0,0,0,0,
0,0,6,0,7,0,0,2,6,0,6,0,0,10,0,0,
7,0,6,0,6,7,0,1,0,0,0,0,10,0,0,0,
6,0,6,0,0,6,0,1,0,0,0,0,0,0,0,0,
0,0,6,0,0,6,0,1,0,0,0,0,0,0,0,0,
0,0,0,0,0,0,0,1,0,0,0,0,0,0,0,0,
0,0,0,0,0,0,0,1,0,0,0,0,0,0,0,0,
0,0,0,0,0,0,0,1,0,0,0,0,0,0,0,0,
0,0,0,10,0,0,0,3,0,0,0,0,0,0,0,0,
0,0,0,0,0,0,0,2,0,0,0,0,0,0,0,0,
0,0,0,0,0,0,0,1,0,0,0,0,0,0,0,0,
0,0,0,0,0,0,0,1,0,0,0,0,0,0,0,0,
0,0,0,0,0,0,0,1,0,0,0,0,0,0,0,0,
0,0,0,0,0,0,0,15,0,0,0,0,0,0,0,0,
9,9,9,9,9,9,9,9,9,9,9,9,9,9,9,9,
8,8,8,8,8,8,8,8,8,8,8,8,8,8,8,8,
8,8,8,8,8,8,8,8,8,8,8,8,8,8,8,8,
8,8,8,8,8,8,8,8,8,8,8,8,8,8,8,8,
8,8,8,8,8,8,8,8,8,8,8,8,8,8,8,8,
8,8,8,8,8,8,8,8,8,8,8,8,8,8,8,8,
8,8,8,8,8,8,8,8,8,8,8,8,8,8,8,8,
8,8,8,8,8,8,8,8,8,8,8,8,8,8,8,8,
8,8,8,8,8,8,8,8,8,8,8,8,8,8,8,8,
8,8,8,8,8,8,8,8,8,8,8,8,8,8,8,8,
8,8,8,8,8,8,8,8,8,8,8,8,8,8,8,8,
8,8,8,8,8,8,8,8,8,8,8,8,8,8,8,8,
8,8,8,8,8,8,8,8,8,8,8,8,8,8,8,8,
8,8,8,8,8,8,8,8,8,8,8,8,8,8,8,8,
8,8,8,8,8,8,8,8,8,8,8,8,8,8,8,8,
8,8,8,8,8,8,8,8,8,8,8,8,8,8,8,8,
8,8,8,8,8,8,8,8,8,8,8,8,8,8,8,8,
8,8,8,8,8,8,8,8,8,8,8,8,8,8,8,8,
8,8,8,8,8,8,8,8,8,8,8,8,8,8,8,8,
8,8,8,8,8,8,8,8,8,8,8,8,8,8,8,8,


createPlayer
64
4448
264
4884
hunter
laser

/*
createPowerUp
64
4400
128
4400
8
false

createPowerUp
64
4350
128
4350
8
false

createPowerUp
64
4300
128
4300
8
false

createPowerUp
64
4250
128
4250
8
false

createPowerUp
64
4200
128
4200
8
false

createPowerUp
64
4150
128
4150
8
false

createPowerUp
64
4100
128
4100
8
false

createPowerUp
64
4050
128
4050
8
false

createPowerUp
64
4000
128
4000
8
false

createPowerUp
64
3950
128
3950
8
false

createPowerUp
64
3900
128
3900
8
false


createPowerUp
64
3850
128
3850
8
false


createBoss
64
3500
200
3500
5
level1
*/